######### ###################
#...#...###...#.#.......#...#
#.....i.....#..#..........$.#
#...#...###...#.#.......#...#
######### ###################
######### ###################
#...#...###...#.#.H.HHH.#...#
#.@...i.H...#.H#..H.H.H...$.#
#...#...###...#.#.HHH.H.#...#
######### ###################
!i 6, 2
This is a block. You can push it any
direction, even diagonally. Move the
blocks out of the way to pass.
