8, 5
...x....
...x....
...x....
...x.#~#
..#.##.$
________
________
_0___@__
________
________
