8, 5
........
.....#..
..#.....
..#..#..
..#.....
________
________
_X_X____
___X____
_@______
