8, 5
........
.....#..
....#...
..#..#..
..#.....
________
________
_0_0____
_@_0____
________
