10, 6
...x...###
...x...~..
...x...~.$
...x...~..
#..#..####
##...##...
__________
__________
_0___@____
__________
__________
__________
__________
__________
