8, 5
........
....#...
.....#..
........
#.......
________
___C____
_AA_B___
_@C_B___
________

