8, 5
........
..xx#...
....~...
....~...
#.......
________
________
_0______
_@0_____
________
