##############
#$.~~~.......#
###~~~~~~~.###
  #~~~~~~~.#
  #~~~~~~~.#
  #~~~~~...#
  #........#
  #........#
  ##########
##############
#$.~~~......@#
###~~~~~~~.###
  #~~~~~~~.#
  #~AAA~~~.#
  #~AAA~...#
  #.AAA....#
  #........#
  ##########

