######
#....####
###...~$#
  #######
_________
_@H______
_________
_________
