#x..x.xxx.
#.x..x...#
#x.x.#.xxx
#.x.#..#x#
.xx.xxx~x#
..x#..xx$#
___@______
__________
__________
__________
__________
_O________
