 #############
##......##...#
#..........$.#
##......##...#
 #############
 #############
##.HH.H.##...#
#@.HH.HH...$.#
##.H.HH.##...#
 #############
