#..x...###
...x...~..
...x...~.$
...x...~..
#..x...###
#.###.####
#.....####
__________
__________
_O___@____
__________
__________
__________
__________
