 ########
##..x...####
#...x...~..#
#...x...~.$#
#...x...~..#
##..x...####
 #.###.##
 #.....#
 #######
____________
____________
____________
__O___@_____
____________
____________
____________
____________
____________
