9, 10
xxxxxxxxx
xx....xxx
x.#xx#.xx
x.xxx.xxx
x.xxxx.xx
x#.##.x#x
x#.##x.#x
x.x~x..xx
x.x$xxxxx
x.xxxxxxx
_________
_________
_________
_________
_________
_________
_________
_0_______
_________
_@_______
