#...............#
.i...............
.................
.................
...........~~....
...#.......~~~...
..#...xxx...~~...
..#...xx.........
#...............#
_________________
_@__H__S____A____
_____H_S____AAA__
_OOO_____________
_________________
_________________
_________________
_________________
_________________

!i 1, 1
This is the playground. It is intended to show off every game mechanic
possible, for testing purposes.
