.................
.i...............
.................
.................
...........~~....
...#.......~~~...
..#...xxx...~~...
..#...xx.........
.................
_________________
_@__H_______A____
_____H______AA___
_OOO_____________
_________________
_________________
_________________
_________________
_________________

!i 1, 1
This is the playground. It is intended to show off every game mechanic
possible, for testing purposes.
