    ######
#####....#####
#............#
#.###....###.#
#..xxx~~xxxx~#
#..xxx~~xxxx~#
#.##########$#
###        ###
    ######
#####.HH.#####
#.....HH.....#
#.###....###.#
#.Sxxx~~xxxx~#
#.Sxxx~~xxxx~#
#@##########$#
###        ###

