  #$~~~.##
  #####~.#
    ##.#.#
   ##x..##
  ##x..##
 ##..x##
##..x##
#.#.##
#..#####
##.....#
  #$~~~~##
  #####~~#
    ##.#.#
   ##xH.##
  ##H..##
 ##..H##
##.Hx##
#.#.##
#..#####
##....@#
