  #$~~~.##
  #####~.#
    ##.#.#
   ##x..##
  ##x..##
 ##..x##
##..x##
#.#.##
#..#####
##.....#
  #$~~~~##
  #####~~#
    ##.#.#
   ##x..##
  ##H.H##
 ##H.H##
##..x##
#.#.##
#..#####
##....@#
