10, 7
..........
..........
..........
....#.....
...#......
..........
#.........
__________
_@___A____
______A___
__________
_C____B___
______BB__
__C_______
