  #######
 ##.....##
##..xxx..##
#..xxxxx..#
#.x~xxxxx.#
#.xx~xxxx.#
#.xxx$xxx.#
#..xxxxx..#
##..xxx..##
 ##.....##
  #######     
  #######
 ##.....##
##..xxx..##
#..xxxxx..#
#.x~xxxxx.#
#.xx~xxxx.#
#.xxx$xxx.#
#..xxxxx..#
##.@xxx..##
 ##.SSS.##
  #######     
