 ######
 #....#
##....#
#.....##
##....$#
 #....##
 #....#
 ######
 ######
 #.AA.#
##.AA.#
#@.BB.##
##.BB.$#
 #.CC.##
 #.CC.#
 ######
